# [Filetype: Wrye Mash Remover]
# All creatures added by Neoptolemus' Morrowind Comes Alive v5.1
# by Dragon32

# MCA 5.1
"_MCA_skeleton"	"Skeleton"
"_MCA_skel_warrior01"	"Skeleton Warrior"
"_MCA_skel_mage"	"Skeleton Mage"
"_MCA_skel_archer01"	"Skeleton Archer"
"_MCA_skel_sorceror"	"Skeleton Sorceror"
"_MCA_skel_knight01"	"Skeleton Knight"
"_MCA_wraith_m"	"Wraith"
"_MCA_skel_lich"	"Lich Lord"
"_MCA_skel_marksman01"	"Skeleton Marksman"
"_MCA_skel_crusader01"	"Skeleton Knight"
"_MCA_skel_crippled_01"	"Crippled Skeleton"
"_MCA_skel_crippled_02"	"Crippled Skeleton"
"_MCA_skel_crippled_03"	"Crippled Skeleton"
"_MCA_skel_crippled_06"	"Crippled Skeleton"
"_MCA_skel_crippled_07"	"Crippled Skeleton"
"_MCA_skel_crippled_08"	"Crippled Skeleton"
"_MCA_skel_crippled_09"	"Crippled Skeleton"
"_MCA_skel_champion01"	"Skeleton Champion"
"_MCA_skel_crippled_04"	"Crippled Skeleton"
"_MCA_skel_crippled_05"	"Crippled Skeleton"
"_MCA_skel_crippled_10"	"Crippled Skeleton"
"_MCA_skel_crippled_11"	"Crippled Skeleton"
"_MCA_wild_e_altmer_f"	"Elder Vampire"
"_MCA_werewolf_40"	"Werewolf"
"_MCA_werewolf_60"	"Werewolf"
"_MCA_werewolf_80"	"Werewolf"
"_MCA_werewolf_20"	"Werewolf"
"_MCA_imp_knight_imp_m"	"Imperial Knight"
"_MCA_noble_imp_f1"	"Noblewoman"
"_MCA_noble_imp_f2"	"Noblewoman"
"_MCA_noble_imp_f3"	"Noblewoman"
"_MCA_noble_dunmer_f1"	"Noblewoman"
"_MCA_noble_dunmer_f2"	"Noblewoman"
"_MCA_noble_dunmer_f3"	"Noblewoman"
"_MCA_noble_imp_m1"	"Nobleman"
"_MCA_noble_imp_m2"	"Nobleman"
"_MCA_noble_dunmer_m1"	"Nobleman"
"_MCA_noble_dunmer_m2"	"Nobleman"
"_MCA_noble_dunmer_m3"	"Nobleman"
"_MCA_imp_guard_imp_m1"	"Imperial Legionary"
"_MCA_imp_archer_imp_m"	"Imperial Archer"
"_MCA_guard_hlaalu_m1"	"Hlaalu Guard"
"_MCA_guard_telvanni_m1"	"Telvanni Guard"
"_MCA_guard_redoran_m1"	"Redoran Guard"
"_MCA_guard_helseth_m"	"Royal Guard"
"_MCA_ordinator_m"	"Ordinator"
"_MCA_ordinator_f"	"Ordinator"
"_MCA_ordinator_high_f"	"High Ordinator"
"_MCA_imp_guard_imp_f1"	"Imperial Legionary"
"_MCA_commoner_dun_m"	"Commoner"
"_MCA_commoner_dun_f"	"Commoner"
"_MCA_pilgrim_m"	"Pilgrim"
"_MCA_pilgrim_f"	"Pilgrim"
"_MCA_layman_imperial_f"	"Lay Sister"
"_MCA_layman_imperial_m"	"Lay Brother"
"_MCA_armiger_m"	"Buoyant Armiger"
"_MCA_armiger_elite_m"	"Elite Buoyant Armiger"
"_MCA_priest_dunmer_m"	"Priest"
"_MCA_priest_dunmer_f"	"Priestess"
"_MCA_priest_imperial_m"	"Priest"
"_MCA_priest_imperial_f"	"Priestess"
"_MCA_priest_breton_f"	"Priestess"
"_MCA_priest_breton_m"	"Priest"
"_MCA_fence_dunmer"	"Fence"
"_MCA_commoner_nord_m"	"Commoner"
"_MCA_commoner_nord_f"	"Commoner"
"_MCA_guard_helseth_f"	"Royal Guard"
"_MCA_guard_hlaalu_f1"	"Hlaalu Guard"
"_MCA_guard_telvanni_f1"	"Telvanni Guard"
"_MCA_noble_dunmer_f4"	"Noblewoman"
"_MCA_noble_dunmer_m4"	"Nobleman"
"_MCA_noble_imp_f4"	"Noblewoman"
"_MCA_fence_imperial"	"Fence"
"_MCA_fence_breton"	"Fence"
"_MCA_fence_bosmer"	"Fence"
"_MCA_fence_redguard"	"Fence"
"_MCA_morag_tong_m"	"Morag Tong Assassin"
"_MCA_morag_tong_f"	"Morag Tong Assassin"
"_MCA_imp_guard_redg_m1"	"Imperial Legionary"
"_MCA_imp_guard_nord_m1"	"Imperial Legionary"
"_MCA_imp_guard_nord_f1"	"Imperial Legionary"
"_MCA_imp_guard_bret_f1"	"Imperial Legionary"
"_MCA_imp_guard_orc_m1"	"Imperial Legionary"
"_MCA_imp_guard_bret_m1"	"Imperial Legionary"
"_MCA_imp_guard_dun_m1"	"Imperial Legionary"
"_MCA_imp_guard_dun_f1"	"Imperial Legionary"
"_MCA_imp_knight_bret_m"	"Imperial Knight"
"_MCA_imp_battlemage"	"Imperial Battlemage"
"_MCA_imp_captain_imp_m"	"Imperial Centurion"
"_MCA_imp_guard_orc_f1"	"Imperial Legionary"
"_MCA_imp_archer_imp_f"	"Imperial Archer"
"_MCA_armiger_f"	"Buoyant Armiger"
"_MCA_armiger_elite_f"	"Elite Buoyant Armiger"
"_MCA_noble_dunmer_f5"	"Noblewoman"
"_MCA_noble_imp_f5"	"Noblewoman"
"_MCA_noble_dunmer_m5"	"Nobleman"
"_MCA_noble_imp_m3"	"Nobleman"
"_MCA_retainer_hlaalu_m1"	"Hlaalu Retainer"
"_MCA_retainer_hlaalu_f1"	"Hlaalu Retainer"
"_MCA_retainer_red_m1"	"Redoran Retainer"
"_MCA_retainer_red_f1"	"Redoran Retainer"
"_MCA_guard_redoran_f1"	"Redoran Guard"
"_MCA_imp_knight_imp_f"	"Imperial Knight"
"_MCA_imp_dragon_knight"	"Imperial Dragon Knight"
"_MCA_courtesan_dun_f1"	"Courtesan"
"_MCA_courtesan_dun_f2"	"Courtesan"
"_MCA_courtesan_dun_f3"	"Courtesan"
"_MCA_courtesan_bos_f1"	"Courtesan"
"_MCA_courtesan_bos_f2"	"Courtesan"
"_MCA_courtesan_bos_f3"	"Courtesan"
"_MCA_courtesan_bret_f1"	"Courtesan"
"_MCA_courtesan_bret_f2"	"Courtesan"
"_MCA_courtesan_bret_f3"	"Courtesan"
"_MCA_courtesan_imp_f1"	"Courtesan"
"_MCA_courtesan_imp_f2"	"Courtesan"
"_MCA_courtesan_alt_f1"	"Courtesan"
"_MCA_courtesan_alt_f2"	"Courtesan"
"_MCA_courtesan_nord_f1"	"Courtesan"
"_MCA_courtesan_nord_f2"	"Courtesan"
"_MCA_courtesan_orc_f"	"Courtesan"
"_MCA_courtesan_redg_f1"	"Courtesan"
"_MCA_courtesan_redg_f2"	"Courtesan"
"_MCA_courtesan_alt_m1"	"Courtesan"
"_MCA_courtesan_alt_m2"	"Courtesan"
"_MCA_courtesan_bos_m2"	"Courtesan"
"_MCA_courtesan_bos_m1"	"Courtesan"
"_MCA_courtesan_bos_m3"	"Courtesan"
"_MCA_courtesan_bret_m1"	"Courtesan"
"_MCA_courtesan_bret_m2"	"Courtesan"
"_MCA_courtesan_imp_m1"	"Courtesan"
"_MCA_courtesan_imp_m2"	"Courtesan"
"_MCA_courtesan_imp_m3"	"Courtesan"
"_MCA_courtesan_dun_m1"	"Courtesan"
"_MCA_courtesan_dun_m2"	"Courtesan"
"_MCA_courtesan_dun_m3"	"Courtesan"
"_MCA_courtesan_nord_m1"	"Courtesan"
"_MCA_courtesan_nord_m2"	"Courtesan"
"_MCA_courtesan_nord_m3"	"Courtesan"
"_MCA_courtesan_redg_m1"	"Courtesan"
"_MCA_courtesan_redg_m2"	"Courtesan"
"_MCA_courtesan_bret_m3"	"Courtesan"
"_MCA_courtesan_bret_f4"	"Courtesan"
"_MCA_courtesan_imp_f3"	"Courtesan"
"_MCA_courtesan_imp_f4"	"Courtesan"
"_MCA_ashlander_f1"	"Ashlander"
"_MCA_ashlander_f3"	"Ashlander"
"_MCA_ashlander_f2"	"Ashlander"
"_MCA_ashlander_m1"	"Ashlander"
"_MCA_ashlander_m3"	"Ashlander"
"_MCA_ashlander_m2"	"Ashlander"
"_MCA_imp_guard_imp_m2"	"Imperial Legionary"
"_MCA_imp_guard_imp_f2"	"Imperial Legionary"
"_MCA_ordinator_elite_f"	"Elite Ordinator"
"_MCA_fence_khajiit"	"Fence"
"_MCA_barbarian_orc"	"Barbarian"
"_MCA_barbarian_nord"	"Barbarian"
"_MCA_barbarian_imperial"	"Barbarian"
"_MCA_beggar_1"	"Beggar"
"_MCA_beggar_2"	"Beggar"
"_MCA_beggar_3"	"Beggar"
"_MCA_beggar_4"	"Beggar"
"_MCA_noble_dunmer_m6"	"Nobleman"
"_MCA_courtesan_dun_f4"	"Courtesan"
"_MCA_courtesan_dun_f5"	"Courtesan"
"_MCA_knight_breton_f3"	"Knight"
"_MCA_knight_breton_m3"	"Knight"
"_MCA_knight_imperial_f3"	"Knight"
"_MCA_knight_imperial_m3"	"Knight"
"_MCA_knight_nord_f3"	"Knight"
"_MCA_knight_nord_m3"	"Knight"
"_MCA_ordinator_patrol"	"Ordinator"
"_MCA_ordinator_elite_p"	"Elite Ordinator"
"_MCA_armiger_patrol"	"Buoyant Armiger"
"_MCA_armiger_elite_ptrl"	"Elite Buoyant Armiger"
"_MCA_champion_altmer_f"	"Champion"
"_MCA_champion_altmer_m"	"Champion"
"_MCA_champion_argonia_f"	"Champion"
"_MCA_champion_argonia_m"	"Champion"
"_MCA_champion_bosmer_f"	"Champion"
"_MCA_champion_bosmer_m"	"Champion"
"_MCA_champion_breton_f"	"Champion"
"_MCA_champion_breton_m"	"Champion"
"_MCA_champion_dunmer_f"	"Champion"
"_MCA_champion_dunmer_m"	"Champion"
"_MCA_champion_imperia_f"	"Champion"
"_MCA_champion_imperia_m"	"Champion"
"_MCA_champion_khajiit_f"	"Champion"
"_MCA_champion_khajiit_m"	"Champion"
"_MCA_champion_nord_f"	"Champion"
"_MCA_champion_nord_m"	"Champion"
"_MCA_champion_redg_f"	"Champion"
"_MCA_champion_redg_m"	"Champion"
"_MCA_champion_orc_f"	"Champion"
"_MCA_champion_orc_m"	"Champion"
"_MCA_archer_altmer_f"	"Archer"
"_MCA_archer_altmer_m"	"Archer"
"_MCA_archer_argonian_f"	"Archer"
"_MCA_archer_argonian_m"	"Archer"
"_MCA_archer_bosmer_f"	"Archer"
"_MCA_archer_bosmer_m"	"Archer"
"_MCA_archer_breton_f"	"Archer"
"_MCA_archer_breton_m"	"Archer"
"_MCA_archer_dunmer_f"	"Archer"
"_MCA_archer_dunmer_m"	"Archer"
"_MCA_archer_imperial_f"	"Archer"
"_MCA_archer_imperial_m"	"Archer"
"_MCA_archer_khajiit_f"	"Archer"
"_MCA_archer_khajiit_m"	"Archer"
"_MCA_archer_nord_f"	"Archer"
"_MCA_archer_nord_m"	"Archer"
"_MCA_archer_orc_f"	"Archer"
"_MCA_archer_orc_m"	"Archer"
"_MCA_archer_redguard_f"	"Archer"
"_MCA_archer_redguard_m"	"Archer"
"_MCA_ordinator_dead"	"Dead Ordinator"
"_MCA_armiger_dead"	"Dead Buoyant Armiger"
"_MCA_traveller_alt_f"	"Traveler"
"_MCA_traveller_alt_m"	"Traveler"
"_MCA_traveller_argo_f"	"Traveler"
"_MCA_traveller_argo_m"	"Traveler"
"_MCA_traveller_redg_f"	"Traveler"
"_MCA_traveller_redg_m"	"Traveler"
"_MCA_traveller_orc_m"	"Traveler"
"_MCA_traveller_orc_f"	"Traveler"
"_MCA_traveller_khaj_f"	"Traveler"
"_MCA_traveller_khaj_m"	"Traveler"
"_MCA_traveller_bos_f"	"Traveler"
"_MCA_traveller_bos_m"	"Traveler"
"_MCA_traveller_bret_m"	"Traveler"
"_MCA_traveller_bret_f"	"Traveler"
"_MCA_traveller_dun_f"	"Traveler"
"_MCA_traveller_dun_m"	"Traveler"
"_MCA_traveller_imp_f"	"Traveler"
"_MCA_traveller_imp_m"	"Traveler"
"_MCA_traveller_nord_f"	"Traveler"
"_MCA_traveller_nord_m"	"Traveler"
"_MCA_knight_breton_m2"	"Knight"
"_MCA_knight_imperial_m2"	"Knight"
"_MCA_knight_nord_m2"	"Knight"
"_MCA_ruffian_dun_m01"	"Ruffian"
"_MCA_ruffian_dun_f01"	"Ruffian"
"_MCA_ruffian_bos_f01"	"Ruffian"
"_MCA_ruffian_bos_m01"	"Ruffian"
"_MCA_ruffian_nord_m01"	"Ruffian"
"_MCA_ruffian_nord_f01"	"Ruffian"
"_MCA_ruffian_bret_m01"	"Ruffian"
"_MCA_ruffian_bret_f01"	"Ruffian"
"_MCA_ruffian_imp_m01"	"Ruffian"
"_MCA_ruffian_imp_f01"	"Ruffian"
"_MCA_ruffian_red_f01"	"Ruffian"
"_MCA_ruffian_red_m01"	"Ruffian"
"_MCA_ruffian_orc_f01"	"Ruffian"
"_MCA_ruffian_orc_m01"	"Ruffian"
"_MCA_ruffian_khaj_f01"	"Ruffian"
"_MCA_ruffian_khaj_m01"	"Ruffian"
"_MCA_outlaw15_bosmer_f"	"Warrior"
"_MCA_outlaw15_bosmer_m"	"Warrior"
"_MCA_outlaw15_breton_f"	"Warrior"
"_MCA_outlaw15_breton_m"	"Warrior"
"_MCA_outlaw15_dunmer_f"	"Warrior"
"_MCA_outlaw15_dunmer_m"	"Warrior"
"_MCA_outlaw15_imp_f"	"Warrior"
"_MCA_outlaw15_imp_m"	"Warrior"
"_MCA_outlaw15_altmer_f"	"Warrior"
"_MCA_outlaw15_altmer_m"	"Warrior"
"_MCA_outlaw15_nord_f"	"Warrior"
"_MCA_outlaw15_nord_m"	"Warrior"
"_MCA_outlaw15_orc_f"	"Warrior"
"_MCA_outlaw15_orc_m"	"Warrior"
"_MCA_outlaw15_redg_f"	"Warrior"
"_MCA_outlaw15_redg_m"	"Warrior"
"_MCA_outlaw40_bosmer_f"	"Outlaw"
"_MCA_outlaw40_bosmer_m"	"Outlaw"
"_MCA_outlaw40_breton_f"	"Outlaw"
"_MCA_outlaw40_breton_m"	"Outlaw"
"_MCA_outlaw40_dunmer_f"	"Outlaw"
"_MCA_outlaw40_dunmer_m"	"Outlaw"
"_MCA_outlaw40_imp_f"	"Outlaw"
"_MCA_outlaw40_imp_m"	"Outlaw"
"_MCA_outlaw40_altmer_m"	"Outlaw"
"_MCA_outlaw40_altmer_f"	"Outlaw"
"_MCA_outlaw40_nord_f"	"Outlaw"
"_MCA_outlaw40_nord_m"	"Outlaw"
"_MCA_outlaw40_orc_m"	"Outlaw"
"_MCA_outlaw40_orc_f"	"Outlaw"
"_MCA_outlaw40_redg_f"	"Outlaw"
"_MCA_outlaw40_redg_m"	"Outlaw"
"_MCA_thief_bosmer_f"	"Thief"
"_MCA_thief_bosmer_m"	"Thief"
"_MCA_thief_breton_m"	"Thief"
"_MCA_thief_breton_f"	"Thief"
"_MCA_thief_dunmer_f"	"Thief"
"_MCA_thief_dunmer_m"	"Thief"
"_MCA_thief_imperial_m"	"Thief"
"_MCA_thief_imperial_f"	"Thief"
"_MCA_thief_khajiit_f"	"Thief"
"_MCA_thief_khajiit_m"	"Thief"
"_MCA_thief_redguard_m"	"Thief"
"_MCA_thief_redguard_f"	"Thief"
"_MCA_knight_breton_f2"	"Knight"
"_MCA_knight_imperial_f2"	"Knight"
"_MCA_knight_nord_f2"	"Knight"
"_MCA_rogue_bosmer_f"	"Rogue"
"_MCA_rogue_bosmer_m"	"Rogue"
"_MCA_rogue_breton_f"	"Rogue"
"_MCA_rogue_breton_m"	"Rogue"
"_MCA_rogue_dunmer_f"	"Rogue"
"_MCA_rogue_dunmer_m"	"Rogue"
"_MCA_rogue_imperial_f"	"Rogue"
"_MCA_rogue_imperial_m"	"Rogue"
"_MCA_rogue_khajiit_f"	"Rogue"
"_MCA_rogue_khajiit_m"	"Rogue"
"_MCA_mage_altmer_f"	"Mage"
"_MCA_mage_altmer_m"	"Mage"
"_MCA_mage_bosmer_f"	"Mage"
"_MCA_mage_bosmer_m"	"Mage"
"_MCA_mage_breton_f"	"Mage"
"_MCA_mage_breton_m"	"Mage"
"_MCA_mage_dunmer_f"	"Mage"
"_MCA_mage_dunmer_m"	"Mage"
"_MCA_mage_imperial_f"	"Mage"
"_MCA_mage_imperial_m"	"Mage"
"_MCA_ahemmusa_m1"	"Ahemmusa Ashlander"
"_MCA_ahemmusa_m2"	"Ahemmusa Ashlander"
"_MCA_ahemmusa_m3"	"Ahemmusa Ashlander"
"_MCA_erabenimsun_m1"	"Erabenimsun Ashlander"
"_MCA_erabenimsun_m2"	"Erabenimsun Ashlander"
"_MCA_erabenimsun_m3"	"Erabenimsun Ashlander"
"_MCA_ahemmusa_f1"	"Ahemmusa Ashlander"
"_MCA_ahemmusa_f2"	"Ahemmusa Ashlander"
"_MCA_ahemmusa_f3"	"Ahemmusa Ashlander"
"_MCA_erabenimsun_f1"	"Erabenimsun Ashlander"
"_MCA_erabenimsun_f2"	"Erabenimsun Ashlander"
"_MCA_erabenimsun_f3"	"Erabenimsun Ashlander"
"_MCA_urshilaku_m1"	"Urshilaku Ashlander"
"_MCA_urshilaku_m2"	"Urshilaku Ashlander"
"_MCA_urshilaku_m3"	"Urshilaku Ashlander"
"_MCA_zainab_m1"	"Zainab Ashlander"
"_MCA_zainab_m2"	"Zainab Ashlander"
"_MCA_zainab_m3"	"Zainab Ashlander"
"_MCA_urshilaku_f1"	"Urshilaku Ashlander"
"_MCA_urshilaku_f2"	"Urshilaku Ashlander"
"_MCA_urshilaku_f3"	"Urshilaku Ashlander"
"_MCA_zainab_f1"	"Zainab Ashlander"
"_MCA_zainab_f2"	"Zainab Ashlander"
"_MCA_zainab_f3"	"Zainab Ashlander"
"_MCA_mage_argonian_f"	"Mage"
"_MCA_mage_khajiit_m"	"Mage"
"_MCA_mage_argonian_m"	"Mage"
"_MCA_mage_khajiit_f"	"Mage"
"_MCA_warrior_altmer_f"	"Warrior"
"_MCA_warrior_altmer_m"	"Warrior"
"_MCA_warrior_argo_f"	"Warrior"
"_MCA_warrior_bosmer_f"	"Warrior"
"_MCA_warrior_bosmer_m"	"Warrior"
"_MCA_warrior_breton_f"	"Warrior"
"_MCA_warrior_breton_m"	"Warrior"
"_MCA_warrior_dunmer_f"	"Warrior"
"_MCA_warrior_dunmer_m"	"Warrior"
"_MCA_warrior_imperial_f"	"Warrior"
"_MCA_warrior_khajiit_f"	"Warrior"
"_MCA_warrior_khajiit_m"	"Warrior"
"_MCA_warrior_nord_f"	"Warrior"
"_MCA_warrior_nord_m"	"Warrior"
"_MCA_warrior_orc_f"	"Warrior"
"_MCA_warrior_orc_m"	"Warrior"
"_MCA_warrior_redguard_f"	"Warrior"
"_MCA_warrior_redguard_m"	"Warrior"
"_MCA_warrior_imperial_m"	"Warrior"
"_MCA_warrior_argo_m"	"Warrior"
"_MCA_mabrigash_04"	"Mabrigash"
"_MCA_ordinator_high_m"	"High Ordinator"
"_MCA_ordinator_hand"	"Hand of Almalexia"
"_MCA_mage_redguard_f"	"Mage"
"_MCA_mage_redguard_m"	"Mage"
"_MCA_rogue_redguard_f"	"Rogue"
"_MCA_rogue_redguard_m"	"Rogue"
"_MCA_ranger_dunmer_m"	"Ranger"
"_MCA_ranger_imperial_m"	"Ranger"
"_MCA_ranger_bosmer_m"	"Ranger"
"_MCA_ranger_nord_m"	"Ranger"
"_MCA_ranger_breton_m"	"Ranger"
"_MCA_novice_dunmer_f"	"Novice"
"_MCA_novice_dunmer_m"	"Novice"
"_MCA_commoner_imp_f"	"Commoner"
"_MCA_commoner_imp_m"	"Commoner"
"_MCA_commoner_alt_f"	"Commoner"
"_MCA_commoner_alt_m"	"Commoner"
"_MCA_commoner_bos_m"	"Commoner"
"_MCA_commoner_bos_f"	"Commoner"
"_MCA_commoner_bret_m"	"Commoner"
"_MCA_commoner_bret_f"	"Commoner"
"_MCA_commoner_arg_m1"	"Commoner"
"_MCA_commoner_arg_m2"	"Commoner"
"_MCA_commoner_arg_m3"	"Commoner"
"_MCA_commoner_arg_m4"	"Commoner"
"_MCA_commoner_arg_m5"	"Commoner"
"_MCA_commoner_arg_m6"	"Commoner"
"_MCA_commoner_arg_f1"	"Commoner"
"_MCA_commoner_arg_f2"	"Commoner"
"_MCA_commoner_arg_f3"	"Commoner"
"_MCA_commoner_khaj_f1"	"Commoner"
"_MCA_commoner_khaj_f2"	"Commoner"
"_MCA_commoner_khaj_f3"	"Commoner"
"_MCA_commoner_khaj_f4"	"Commoner"
"_MCA_commoner_khaj_m1"	"Commoner"
"_MCA_commoner_khaj_m2"	"Commoner"
"_MCA_commoner_khaj_m3"	"Commoner"
"_MCA_commoner_khaj_m4"	"Commoner"
"_MCA_commoner_orc_m"	"Commoner"
"_MCA_commoner_orc_f"	"Commoner"
"_MCA_commoner_redg_m"	"Commoner"
"_MCA_commoner_redg_f"	"Commoner"
"_MCA_barbarian_breton"	"Barbarian"
"_MCA_prisoner_arg"	"Prisoner"
"_MCA_prisoner_bret"	"Prisoner"
"_MCA_prisoner_dunm"	"Prisoner"
"_MCA_prisoner_imp"	"Prisoner"
"_MCA_prisoner_khaj"	"Prisoner"
"_MCA_prisoner_nord"	"Prisoner"
"_MCA_prisoner_orc"	"Prisoner"
"_MCA_prisoner_redg"	"Prisoner"
"_MCA_BM_commoner_f"	"Villager"
"_MCA_BM_commoner_m"	"Villager"
"_MCA_BM_huntsman_m1"	"Huntsman"
"_MCA_BM_huntsman_m2"	"Huntsman"
"_MCA_BM_huntsman_m3"	"Huntsman"
"_MCA_BM_huntsman_m4"	"Huntsman"
"_MCA_BM_warrior_m2"	"Warrior"
"_MCA_BM_warrior_m1"	"Warrior"
"_MCA_BM_warrior_m3"	"Warrior"
"_MCA_BM_barbarian_m"	"Barbarian"
"_MCA_imp_guard_bret_m2"	"Imperial Legionary"
"_MCA_imp_guard_bret_f2"	"Imperial Legionary"
"_MCA_imp_guard_redg_f1"	"Imperial Legionary"
"_MCA_courtesan_nord_f3"	"Courtesan"
"_MCA_courtesan_nord_f4"	"Courtesan"
"_MCA_guard_hlaalu_p"	"Hlaalu Guard"
"_MCA_guard_telvanni_p"	"Telvanni Guard"
"_MCA_guard_redoran_p"	"Redoran Guard"
"_MCA_dreamer_warrior_m"	"Dreamer Warrior"
"_MCA_dreamer_priest_m1"	"Dreamer Priest"
"_MCA_dreamer_archer_m"	"Dreamer Archer"
"_MCA_dreamer_warrior_f"	"Dreamer Warrior"
"_MCA_dreamer_archer_f"	"Dreamer Archer"
"_MCA_dreamer_priest_m2"	"Dreamer Priest"
"_MCA_dreamer_m1"	"Dreamer"
"_MCA_dreamer_m2"	"Dreamer"
"_MCA_dreamer_m3"	"Dreamer"
"_MCA_dreamer_m4"	"Dreamer"
"_MCA_dreamer_m5"	"Dreamer"
"_MCA_dreamer_f1"	"Dreamer"
"_MCA_dreamer_f2"	"Dreamer"
"_MCA_dreamer_f3"	"Dreamer"
"_MCA_dreamer_f4"	"Dreamer"
"_MCA_dreamer_f5"	"Dreamer"
"_MCA_dreamer_prophet_m2"	"Dreamer Prophet"
"_MCA_dreamer_prophet_m1"	"Dreamer Prophet"
"_MCA_dreamer_champion_m"	"Dreamer Champion"
"_MCA_dreamer_sharp_m"	"Dreamer Sharpshooter"
"_MCA_dreamer_priestess"	"Dreamer Priestess"
"_MCA_dreamer_sharp_f"	"Dreamer Sharpshooter"
"_MCA_dreamer_champion_f"	"Dreamer Champion"
"_MCA_witch_redguard_m"	"Warlock"
"_MCA_witch_redguard_f"	"Witch"
"_MCA_witch_altmer_f"	"Witch"
"_MCA_witch_altmer_m"	"Warlock"
"_MCA_witch_breton_m"	"Warlock"
"_MCA_witch_dunmer_m"	"Warlock"
"_MCA_witch_imperial_m"	"Warlock"
"_MCA_witch_bosmer_m"	"Warlock"
"_MCA_witch_breton_f"	"Witch"
"_MCA_witch_dunmer_f"	"Witch"
"_MCA_witch_imperial_f"	"Witch"
"_MCA_witch_bosmer_f"	"Witch"
"_MCA_witch_orc_f"	"Witch"
"_MCA_witch_orc_m"	"Warlock"
"_MCA_witch_nord_m"	"Warlock"
"_MCA_witch_nord_f"	"Witch"
"_MCA_orc_champion_f"	"Orc Champion"
"_MCA_orc_champion_m"	"Orc Champion"
"_MCA_outlaw20_breton_m"	"Archer"
"_MCA_outlaw20_imp_m"	"Archer"
"_MCA_outlaw20_dunmer_m"	"Archer"
"_MCA_outlaw20_bosmer_f"	"Archer"
"_MCA_outlaw20_altmer_m"	"Archer"
"_MCA_outlaw20_altmer_f"	"Archer"
"_MCA_outlaw20_bosmer_m"	"Archer"
"_MCA_outlaw20_dunmer_f"	"Archer"
"_MCA_outlaw20_breton_f"	"Archer"
"_MCA_outlaw20_imp_f"	"Archer"
"_MCA_outlaw20_nord_m"	"Archer"
"_MCA_outlaw20_nord_f"	"Archer"
"_MCA_outlaw20_orc_m"	"Archer"
"_MCA_outlaw20_redg_f"	"Archer"
"_MCA_outlaw20_redg_m"	"Archer"
"_MCA_outlaw20_orc_f"	"Archer"
"_MCA_courtesan_imp_m4"	"Courtesan"
"_MCA_imp_marks_imp_m"	"Imperial Marksman"
"_MCA_imp_marks_imp_f"	"Imperial Markswoman"
"_MCA_imp_dukes_imp_m"	"Duke's Guard"
"_MCA_imp_dukes_imp_f"	"Duke's Guard"
"_MCA_outcast_f_05b"	"Outcast Ashlander"
"_MCA_outcast_f_05a"	"Outcast Ashlander"
"_MCA_outcast_f_15b"	"Outcast Ashlander"
"_MCA_outcast_f_15a"	"Outcast Ashlander"
"_MCA_outcast_f_30b"	"Outcast Ashlander"
"_MCA_outcast_f_30a"	"Outcast Ashlander"
"_MCA_outcast_m_05a"	"Outcast Ashlander"
"_MCA_outcast_m_05b"	"Outcast Ashlander"
"_MCA_outcast_m_15a"	"Outcast Ashlander"
"_MCA_outcast_m_15b"	"Outcast Ashlander"
"_MCA_outcast_m_30a"	"Outcast Ashlander"
"_MCA_outcast_m_30b"	"Outcast Ashlander"
"_MCA_mabrigash_01"	"Mabrigash"
"_MCA_mabrigash_05"	"Mabrigash"
"_MCA_mabrigash_06"	"Mabrigash"
"_MCA_mabrigash_02"	"Mabrigash"
"_MCA_mabrigash_03"	"Mabrigash"
"_MCA_retainer_hlaalu_m2"	"Hlaalu Retainer"
"_MCA_retainer_hlaalu_m3"	"Hlaalu Retainer"
"_MCA_retainer_hlaalu_f2"	"Hlaalu Retainer"
"_MCA_retainer_hlaalu_f3"	"Hlaalu Retainer"
"_MCA_retainer_hlaalu_f4"	"Hlaalu Retainer"
"_MCA_retainer_hlaalu_m4"	"Hlaalu Retainer"
"_MCA_retainer_red_f2"	"Redoran Retainer"
"_MCA_retainer_red_f3"	"Redoran Retainer"
"_MCA_retainer_red_f4"	"Redoran Retainer"
"_MCA_retainer_tel_f1"	"Telvanni Retainer"
"_MCA_retainer_red_m2"	"Redoran Retainer"
"_MCA_retainer_red_m4"	"Redoran Retainer"
"_MCA_retainer_red_m3"	"Redoran Retainer"
"_MCA_retainer_tel_m1"	"Telvanni Retainer"
"_MCA_retainer_tel_m2"	"Telvanni Retainer"
"_MCA_retainer_tel_m4"	"Telvanni Retainer"
"_MCA_imp_knight_bret_f"	"Imperial Knight"
"_MCA_retainer_tel_f2"	"Telvanni Retainer"
"_MCA_retainer_tel_f3"	"Telvanni Retainer"
"_MCA_retainer_tel_f4"	"Telvanni Retainer"
"_MCA_retainer_tel_m3"	"Telvanni Retainer"
"_MCA_ruffian_bos_f02"	"Ruffian"
"_MCA_ruffian_bos_m02"	"Ruffian"
"_MCA_ruffian_bret_f02"	"Ruffian"
"_MCA_ruffian_dun_f02"	"Ruffian"
"_MCA_ruffian_imp_f02"	"Ruffian"
"_MCA_ruffian_khaj_f02"	"Ruffian"
"_MCA_ruffian_bret_m02"	"Ruffian"
"_MCA_ruffian_dun_m02"	"Ruffian"
"_MCA_ruffian_imp_m02"	"Ruffian"
"_MCA_ruffian_khaj_m02"	"Ruffian"
"_MCA_ruffian_nord_m02"	"Ruffian"
"_MCA_ruffian_orc_m02"	"Ruffian"
"_MCA_ruffian_red_m02"	"Ruffian"
"_MCA_ruffian_nord_f02"	"Ruffian"
"_MCA_ruffian_orc_f02"	"Ruffian"
"_MCA_ruffian_red_f02"	"Ruffian"
"_MCA_imp_archer_bret_f"	"Imperial Archer"
"_MCA_imp_marks_bret_f"	"Imperial Markswoman"
"_MCA_imp_marks_bret_m"	"Imperial Marksman"
"_MCA_imp_archer_bret_m"	"Imperial Archer"
"_MCA_imp_guard_dun_f2"	"Imperial Legionary"
"_MCA_imp_archer_dun_f"	"Imperial Archer"
"_MCA_imp_marks_dun_f"	"Imperial Markswoman"
"_MCA_imp_guard_dun_m2"	"Imperial Legionary"
"_MCA_imp_marks_dun_m"	"Imperial Marksman"
"_MCA_imp_archer_dun_m"	"Imperial Archer"
"_MCA_imp_guard_nord_f2"	"Imperial Legionary"
"_MCA_imp_archer_nord_f"	"Imperial Archer"
"_MCA_imp_marks_nord_f"	"Imperial Markswoman"
"_MCA_imp_guard_nord_m2"	"Imperial Legionary"
"_MCA_imp_archer_nord_m"	"Imperial Archer"
"_MCA_imp_marks_nord_m"	"Imperial Marksman"
"_MCA_imp_guard_orc_f2"	"Imperial Legionary"
"_MCA_imp_archer_orc_f"	"Imperial Archer"
"_MCA_imp_guard_orc_m2"	"Imperial Legionary"
"_MCA_imp_archer_orc_m"	"Imperial Archer"
"_MCA_imp_guard_redg_f2"	"Imperial Legionary"
"_MCA_imp_archer_redg_f"	"Imperial Archer"
"_MCA_imp_guard_redg_m2"	"Imperial Legionary"
"_MCA_imp_archer_redg_m"	"Imperial Archer"
"_MCA_orc_warrior_f"	"Orc Warrior"
"_MCA_orc_warrior_m"	"Orc Warrior"
"_MCA_orc_shaman_f"	"Orc Shaman"
"_MCA_orc_barbarian_m"	"Orc Barbarian"
"_MCA_orc_shaman_m"	"Orc Shaman"
"_MCA_orc_archer_f"	"Orc Archer"
"_MCA_orc_archer_m"	"Orc Archer"
"_MCA_orc_marksman_m"	"Orc Marksman"
"_MCA_orc_berserker_m"	"Orc Berserker"
"_MCA_imp_marks_orc_m"	"Imperial Marksman"
"_MCA_ruffian_ambush"	
"_MCA_skel_archer02"	"Skeleton Archer"
"_MCA_skel_warrior02"	"Skeleton Warrior"
"_MCA_skel_champion02"	"Skeleton Champion"
"_MCA_skel_knight02"	"Skeleton Knight"
"_MCA_skel_crusader02"	"Skeleton Knight"
"_MCA_skel_marksman02"	"Skeleton Marksman"
"_MCA_phan_archer02"	"Phantom Archer"
"_MCA_phan_champion02"	"Phantom Champion"
"_MCA_phan_crusader02"	"Phantom Crusader"
"_MCA_phan_knight02"	"Phantom Knight"
"_MCA_phan_mage"	"Phantom Mage"
"_MCA_phan_marksman02"	"Phantom Marksman"
"_MCA_phan_sorceror"	"Phantom Sorceror"
"_MCA_phan_warrior02"	"Phantom Warrior"
"_MCA_phantom"	"Phantom"
"_MCA_phan_archer01"	"Phantom Archer"
"_MCA_phan_champion01"	"Phantom Champion"
"_MCA_phan_knight01"	"Phantom Knight"
"_MCA_phan_marksman01"	"Phantom Marksman"
"_MCA_phan_crusader01"	"Phantom Crusader"
"_MCA_phan_warrior01"	"Phantom Warrior"
"_MCA_companion_susan"	"Susan"
"_MCA_companion_mordred"	"Mordred of Wyrmhaven"
"_MCA_companion_wolf"	"Wolf"
"_MCA_companion_laeril"	"Laeril"
"_MCA_companion_eowyn"	"Éowyn"
"_MCA_companion_marianne"	"Marianne de Castor"
"_MCA_companion_khann"	"Khann Sershurrapal"
"_MCA_companion_unferth"	"Unferth Windfoot"
"_MCA_companion_edhrinor"	"Edhrinor"
"_MCA_companion_elira"	"Elira Uvendas"
"_MCA_companion_noldomir"	"Noldomir"
"_MCA_companion_mina"	"Mina Indoril"
"_MCA_companion_medea"	"Medea"
"_MCA_companion_mirear"	"Mirëar"
"_MCA_companion_annah"	"Annah Indaren"
"_MCA_companion_catherin"	"Catherine de Castor"
"_MCA_companion_luthien"	"Luthien Morvayn"
"_MCA_companion_octavius"	"Octavius Antiochus"
"_MCA_companion_bracchus"	"Bracchus Witchbane"
"_MCA_companion_draythen"	"Draythen Llethri"
"_MCA_companion_ghrash"	"Ghrash gro-Dungroth"
"_MCA_companion_hrothulf"	"Hrothulf the Restless"
"_MCA_companion_ali"	"Ali"
"_MCA_companion_persepho"	"Persephone"
"_MCA_companion_shareel"	"Shareel"
"_MCA_companion_edward"	"Edward of Glenumbra"
"_MCA_companion_malthus"	"Malthus Retheran"
"_MCA_companion_isolde"	"Isolde"
"_MCA_companion_josephin"	"Josephine Deudonne"
"_MCA_companion_quintus"	"Quintus Ambrosinius"
"_MCA_companion_reynald"	"Reynald the Pike"
"_MCA_companion_swims"	"Swims-In-Ice-Water"
"_MCA_companion_yasam"	"Y'asam"
"_MCA_companion_sharp"	"Sharp-Claws"
"_MCA_companion_leemka"	"Leem-Ka"
"_MCA_companion_yasmine"	"Yasmine"
"_MCA_companion_sam"	"Sam"
"_MCA_companion_tsenyi"	"Tsenyi"
"_MCA_companion_pharakho"	"Pharakhor the Damned"
"_MCA_companion_symmachu"	"Symmachus"
"_MCA_companion_selena"	"Selena"
"_MCA_companion_telania"	"Telania Neloth"
"_MCA_companion_raaj"	"Raaj"
"_MCA_companion_erik"	"Erik the Stubborn"
"_MCA_companion_kagha"	"Kagha gra-Ugdush"
"_MCA_companion_ufthak"	"Ufthak gro-Boldog"
"_MCA_companion_neldor"	"Neldor"
"_MCA_companion_telion"	"Telion the Terrible"
"_MCA_companion_olivia"	"Olivia Delitian"
"_MCA_zombie01"	"Zombie"
"_MCA_zombie_knight05"	"Zombie Knight"
"_MCA_zombie_knight02"	"Zombie Knight"
"_MCA_zombie_knight04"	"Zombie Knight"
"_MCA_zombie_archer01"	"Zombie Archer"
"_MCA_zombie_archer02"	"Zombie Archer"
"_MCA_zombie_champion01"	"Zombie Champion"
"_MCA_zombie_knight01"	"Zombie Knight"
"_MCA_zombie_champion02"	"Zombie Champion"
"_MCA_zombie_mage01"	"Zombie Mage"
"_MCA_zombie_warrior01"	"Zombie Warrior"
"_MCA_zombie_warrior02"	"Zombie Warrior"
"_MCA_knight_nord_m1"	"Knight"
"_MCA_knight_nord_f1"	"Knight"
"_MCA_knight_imperial_f1"	"Knight"
"_MCA_knight_breton_m1"	"Knight"
"_MCA_knight_breton_f1"	"Knight"
"_MCA_knight_imperial_m1"	"Knight"
"_MCA_skel_knight03"	"Skeleton Knight"
"_MCA_zombie_knight03"	"Zombie Knight"
"_MCA_ninja_bosmer_m"	"Assassin"
"_MCA_ninja_bosmer_f"	"Assassin"
"_MCA_ninja_breton_f"	"Assassin"
"_MCA_ninja_breton_m"	"Assassin"
"_MCA_ninja_dunmer_m"	"Assassin"
"_MCA_ninja_dunmer_f"	"Assassin"
"_MCA_ninja_imperial_f"	"Assassin"
"_MCA_ninja_imperial_m"	"Assassin"
"_MCA_ninja_redguard_m"	"Assassin"
"_MCA_ninja_redguard_f"	"Assassin"
"_MCA_assassin_imp_f"	"Assassin"
"_MCA_assassin_bosmer_f"	"Assassin"
"_MCA_assassin_dunmer_f"	"Assassin"
"_MCA_assassin_imp_m"	"Assassin"
"_MCA_assassin_breton_m"	"Assassin"
"_MCA_assassin_dunmer_m"	"Assassin"
"_MCA_assassin_breton_f"	"Assassin"
"_MCA_assassin_redg_f"	"Assassin"
"_MCA_assassin_redg_m"	"Assassin"
"_MCA_assassin_bosmer_m"	"Assassin"
"_MCA_ranger_nord_f"	"Ranger"
"_MCA_ranger_dunmer_f"	"Ranger"
"_MCA_ranger_breton_f"	"Ranger"
"_MCA_ranger_bosmer_f"	"Ranger"
"_MCA_ranger_imperial_f"	"Ranger"
"_MCA_layman_breton_m"	"Lay Brother"
"_MCA_layman_breton_f"	"Lay Sister"
"_MCA_layman_nord_f"	"Lay Sister"
"_MCA_layman_redg_f"	"Lay Sister"
"_MCA_layman_redg_m"	"Lay Brother"
"_MCA_layman_nord_m"	"Lay Brother"
"_MCA_priest_nord_f"	"Priestess"
"_MCA_priest_nord_m"	"Priest"
"_MCA_phan_knight03"	"Phantom Knight"
"_MCA_necromancer_alt_m"	"Necromancer"
"_MCA_necromancer_alt_f"	"Necromancer"
"_MCA_necromancer_bret_f"	"Necromancer"
"_MCA_necromancer_bret_m"	"Necromancer"
"_MCA_necromancer_dun_m"	"Necromancer"
"_MCA_necromancer_dun_f"	"Necromancer"
"_MCA_imp_knight_nord_f"	"Imperial Knight"
"_MCA_imp_knight_nord_m"	"Imperial Knight"
"_MCA_imp_dukes_dun_m"	"Duke's Guard"
"_MCA_imp_dukes_dun_f"	"Duke's Guard"
"_MCA_courtesan_alt_f3"	"Courtesan"
"_MCA_courtesan_imp_m5"	"Courtesan"
"_MCA_courtesan_bret_m4"	"Courtesan"
"_MCA_courtesan_bret_m5"	"Courtesan"
"_MCA_zombie_headless01"	"Headless Zombie"
"_MCA_zombie02"	"Zombie"
"_MCA_corpse_altmer_f"	"Corpse"
"_MCA_corpse_breton_f"	"Corpse"
"_MCA_corpse_dunmer_f"	"Corpse"
"_MCA_corpse_imperial_f"	"Corpse"
"_MCA_corpse_nord_f"	"Corpse"
"_MCA_corpse_orc_f"	"Corpse"
"_MCA_corpse_redg_f"	"Corpse"
"_MCA_corpse_bosmer_f"	"Corpse"
"_MCA_corpse_khajiit_f"	"Corpse"
"_MCA_corpse_argonian_f"	"Corpse"
"_MCA_corpse_altmer_m"	"Corpse"
"_MCA_corpse_bosmer_m"	"Corpse"
"_MCA_corpse_dunmer_m"	"Corpse"
"_MCA_corpse_breton_m"	"Corpse"
"_MCA_corpse_imperial_m"	"Corpse"
"_MCA_corpse_nord_m"	"Corpse"
"_MCA_corpse_orc_m"	"Corpse"
"_MCA_corpse_redg_m"	"Corpse"
"_MCA_corpse_argonian_m"	"Corpse"
"_MCA_corpse_khajiit_m"	"Corpse"
"_MCA_corpse_skeleton"	"Corpse"
"_MCA_corpse_zombie_m"	"Corpse"
"_MCA_necromancer_imp_m"	"Necromancer"
"_MCA_necromancer_imp_f"	"Necromancer"
"_MCA_necromancer_bos_f"	"Necromancer"
"_MCA_necromancer_bos_m"	"Necromancer"
"_MCA_necromancer_redg_m"	"Necromancer"
"_MCA_necromancer_redg_f"	"Necromancer"
"_MCA_necromancer_nord_f"	"Necromancer"
"_MCA_necromancer_nord_m"	"Necromancer"
"_MCA_imp_patrol_captain"	"Imperial Centurion"
"_MCA_imp_patrol_guard"	"Imperial Legionary"
"_MCA_courtesan_bret_f5"	"Courtesan"
"_MCA_courtesan_bret_f6"	"Courtesan"
"_MCA_courtesan_bret_f7"	"Courtesan"
"_MCA_dunmer_thief_m"	"Thief"
"_MCA_dunmer_thief_f"	"Thief"
"_MCA_dunmer_warrior_m"	"Thug"
"_MCA_dunmer_warrior_f"	"Thug"
"_MCA_dunmer_archer_f"	"Archer"
"_MCA_dunmer_archer_m"	"Archer"
"_MCA_dunmer_crossbow_m"	"Marksman"
"_MCA_dunmer_crossbow_f"	"Markswoman"
"_MCA_dunmer_bone_m"	"Warrior"
"_MCA_dunmer_bone_f"	"Warrior"
"_MCA_dunmer_iron_m"	"Warrior"
"_MCA_dunmer_iron_f"	"Warrior"
"_MCA_dunmer_thug_f1"	"Thug"
"_MCA_dunmer_thug_m1"	"Thug"
"_MCA_dunmer_ambush"	
"_MCA_courtesan_bos_m4"	"Courtesan"
"_MCA_courtesan_bos_f4"	"Courtesan"
"_MCA_courtesan_bos_f5"	"Courtesan"
"_MCA_courtesan_redg_f3"	"Courtesan"
"_MCA_courtesan_redg_f4"	"Courtesan"
"_MCA_courtesan_redg_f5"	"Courtesan"
"_MCA_courtesan_redg_m3"	"Courtesan"
"_MCA_courtesan_redg_m4"	"Courtesan"
"_MCA_dunmer_thug_m2"	"Thug"
"_MCA_dunmer_thug_f2"	"Thug"
"_MCA_wraith_f"	"Wraith"
"_MCA_wraith_lord_m"	"Wraith Lord"
"_MCA_wraith_lord_f"	"Wraith Lady"
"_MCA_wraith_ambush"	
"_MCA_BM_wraith"	"Frost Wraith"
"_MCA_bandit_nord_m01"	"Bandit"
"_MCA_bandit_nord_m02"	"Bandit"
"_MCA_bandit_orc_m01"	"Bandit"
"_MCA_bandit_orc_m02"	"Bandit"
"_MCA_bandit_red_m01"	"Bandit"
"_MCA_bandit_red_m02"	"Bandit"
"_MCA_bandit_dun_m01"	"Bandit"
"_MCA_bandit_khaj_m01"	"Bandit"
"_MCA_bandit_dun_m02"	"Bandit"
"_MCA_bandit_khaj_m02"	"Bandit"
"_MCA_bandit_nord_f01"	"Bandit"
"_MCA_bandit_nord_f02"	"Bandit"
"_MCA_bandit_bret_m01"	"Bandit"
"_MCA_bandit_bret_m02"	"Bandit"
"_MCA_bandit_khaj_f01"	"Bandit"
"_MCA_bandit_imp_m01"	"Bandit"
"_MCA_bandit_dun_f02"	"Bandit"
"_MCA_bandit_imp_m02"	"Bandit"
"_MCA_bandit_orc_f01"	"Bandit"
"_MCA_bandit_orc_f02"	"Bandit"
"_MCA_bandit_khaj_f02"	"Bandit"
"_MCA_bandit_red_f01"	"Bandit"
"_MCA_bandit_bos_m01"	"Bandit"
"_MCA_bandit_bos_m02"	"Bandit"
"_MCA_bandit_red_f02"	"Bandit"
"_MCA_bandit_bret_f01"	"Bandit"
"_MCA_bandit_bos_f01"	"Bandit"
"_MCA_bandit_bos_f02"	"Bandit"
"_MCA_bandit_dun_f01"	"Bandit"
"_MCA_bandit_imp_f01"	"Bandit"
"_MCA_bandit_imp_f02"	"Bandit"
"_MCA_bandit_bret_f02"	"Bandit"
"_MCA_footpad_nord_m"	"Footpad"
"_MCA_footpad_breton_m"	"Footpad"
"_MCA_footpad_dunmer_m"	"Footpad"
"_MCA_footpad_imperial_m"	"Footpad"
"_MCA_footpad_khajiit_m"	"Footpad"
"_MCA_footpad_orc_m"	"Footpad"
"_MCA_footpad_redguard_m"	"Footpad"
"_MCA_footpad_bosmer_m"	"Footpad"
"_MCA_footpad_nord_f"	"Footpad"
"_MCA_footpad_breton_f"	"Footpad"
"_MCA_footpad_dunmer_f"	"Footpad"
"_MCA_footpad_imperial_f"	"Footpad"
"_MCA_footpad_khajiit_f"	"Footpad"
"_MCA_footpad_orc_f"	"Footpad"
"_MCA_footpad_redguard_f"	"Footpad"
"_MCA_footpad_bosmer_f"	"Footpad"
"_MCA_bandit_ambush"	
"_MCA_footpad_ambush"	
"_MCA_BM_smuggler_bos_f1"	"Smuggler"
"_MCA_BM_smuggler_bos_m1"	"Smuggler"
"_MCA_BM_smuggler_bre_m1"	"Smuggler"
"_MCA_BM_smuggler_bre_f1"	"Smuggler"
"_MCA_BM_smuggler_dun_f1"	"Smuggler"
"_MCA_BM_smuggler_dun_m1"	"Smuggler"
"_MCA_BM_smuggler_imp_m1"	"Smuggler"
"_MCA_BM_smuggler_imp_f1"	"Smuggler"
"_MCA_BM_smuggler_nor_f1"	"Smuggler"
"_MCA_BM_smuggler_nor_m1"	"Smuggler"
"_MCA_BM_smuggler_orc_m1"	"Smuggler"
"_MCA_BM_smuggler_orc_f1"	"Smuggler"
"_MCA_BM_smuggler_red_f1"	"Smuggler"
"_MCA_BM_smuggler_red_m1"	"Smuggler"
"_MCA_BM_smuggler_kha_f1"	"Smuggler"
"_MCA_BM_smuggler_kha_m1"	"Smuggler"
"_MCA_BM_skel_archer01"	"Skeleton Archer"
"_MCA_BM_skel_knight02"	"Skeleton Knight"
"_MCA_BM_skel_knight01"	"Skeleton Knight"
"_MCA_BM_skel_archer02"	"Skeleton Archer"
"_MCA_BM_skel_shaman"	"Skeleton Shaman"
"_MCA_BM_skel_champion02"	"Skeleton Champion"
"_MCA_BM_skel_marksman01"	"Skeleton Marksman"
"_MCA_BM_skel_marksman02"	"Skeleton Marksman"
"_MCA_BM_skel_warrior02"	"Skeleton Warrior"
"_MCA_BM_skel_warrior01"	"Skeleton Warrior"
"_MCA_BM_skeleton"	"Skeleton"
"_MCA_BM_skel_champion01"	"Skeleton Champion"
"_MCA_BM_draugr_shaman"	"Draugr Shaman"
"_MCA_BM_draugr_champ02"	"Draugr Champion"
"_MCA_BM_draugr_knight02"	"Draugr Knight"
"_MCA_BM_draugr_champ01"	"Draugr Champion"
"_MCA_BM_draugr_archer01"	"Draugr Archer"
"_MCA_BM_draugr_archer02"	"Draugr Archer"
"_MCA_BM_draugr_knight01"	"Draugr Knight"
"_MCA_BM_draugr_war01"	"Draugr Warrior"
"_MCA_BM_draugr_war02"	"Draugr Warrior"
"_MCA_BM_draugr"	"Draugr"
"_MCA_zombie03"	"Zombie"
"_MCA_zombie04"	"Zombie"
"_MCA_zombie05"	"Zombie"
"_MCA_BM_draugr_berserk1"	"Draugr Berserker"
"_MCA_BM_skel_berserk01"	"Skeleton Berserker"
"_MCA_BM_draugr_berserk2"	"Draugr Berserker"
"_MCA_BM_skel_berserk02"	"Skeleton Berserker"
"_MCA_BM_skel_reaver02"	"Skeleton Reaver"
"_MCA_BM_skel_reaver04"	"Skeleton Reaver"
"_MCA_BM_skel_reaver01"	"Skeleton Reaver"
"_MCA_BM_skel_reaver03"	"Skeleton Reaver"
"_MCA_BM_skel_reaver06"	"Skeleton Reaver"
"_MCA_BM_skel_reaver08"	"Skeleton Reaver"
"_MCA_BM_skel_reaver05"	"Skeleton Reaver"
"_MCA_BM_skel_reaver07"	"Skeleton Reaver"
"_MCA_BM_draugr_reaver02"	"Draugr Reaver"
"_MCA_BM_draugr_reaver04"	"Draugr Reaver"
"_MCA_BM_draugr_reaver06"	"Draugr Reaver"
"_MCA_BM_draugr_reaver08"	"Draugr Reaver"
"_MCA_BM_draugr_reaver03"	"Draugr Reaver"
"_MCA_BM_draugr_reaver07"	"Draugr Reaver"
"_MCA_BM_draugr_reaver01"	"Draugr Reaver"
"_MCA_BM_draugr_reaver05"	"Draugr Reaver"
"_MCA_zombie_knight08"	"Zombie Knight"
"_MCA_zombie_knight07"	"Zombie Knight"
"_MCA_zombie_knight10"	"Zombie Knight"
"_MCA_zombie_archer03"	"Zombie Archer"
"_MCA_zombie_archer04"	"Zombie Archer"
"_MCA_zombie_champion03"	"Zombie Champion"
"_MCA_zombie_champion04"	"Zombie Champion"
"_MCA_zombie_knight09"	"Zombie Knight"
"_MCA_zombie_headless02"	"Headless Zombie"
"_MCA_zombie_knight06"	"Zombie Knight"
"_MCA_zombie_mage02"	"Zombie Mage"
"_MCA_zombie_warrior03"	"Zombie Warrior"
"_MCA_zombie_warrior04"	"Zombie Warrior"
"_MCA_BM_reaver01"	"Reaver"
"_MCA_BM_reaver02"	"Reaver"
"_MCA_BM_reaver03"	"Reaver"
"_MCA_BM_reaver04"	"Reaver"
"_MCA_BM_reaver07"	"Reaver"
"_MCA_BM_reaver08"	"Reaver"
"_MCA_BM_reaver05"	"Reaver"
"_MCA_BM_reaver06"	"Reaver"
"_MCA_BM_smuggler_nor_m2"	"Smuggler"
"_MCA_BM_smuggler_orc_m2"	"Smuggler"
"_MCA_BM_smuggler_nor_f2"	"Smuggler"
"_MCA_BM_smuggler_orc_f2"	"Smuggler"
"_MCA_BM_smuggler_red_m2"	"Smuggler"
"_MCA_BM_smuggler_imp_m2"	"Smuggler"
"_MCA_BM_smuggler_red_f2"	"Smuggler"
"_MCA_BM_smuggler_bre_m2"	"Smuggler"
"_MCA_BM_smuggler_dun_m2"	"Smuggler"
"_MCA_BM_smuggler_imp_f2"	"Smuggler"
"_MCA_BM_smuggler_bos_f2"	"Smuggler"
"_MCA_BM_smuggler_dun_f2"	"Smuggler"
"_MCA_BM_smuggler_bre_f2"	"Smuggler"
"_MCA_BM_smuggler_bos_m2"	"Smuggler"
"_MCA_BM_smuggler_kha_f2"	"Smuggler"
"_MCA_BM_smuggler_kha_m2"	"Smuggler"
"_MCA_noble_imp_m4"	"Nobleman"
"_MCA_noble_breton_f2"	"Noblewoman"
"_MCA_noble_breton_f3"	"Noblewoman"
"_MCA_noble_breton_f1"	"Noblewoman"
"_MCA_noble_breton_f4"	"Noblewoman"
"_MCA_noble_breton_f5"	"Noblewoman"
"_MCA_noble_breton_f6"	"Noblewoman"
"_MCA_noble_imp_f6"	"Noblewoman"
"_MCA_telvanni_altmer_f"	"Telvanni Mage"
"_MCA_telvanni_altmer_m"	"Telvanni Mage"
"_MCA_telvanni_bosmer_f"	"Telvanni Mage"
"_MCA_telvanni_bosmer_m"	"Telvanni Mage"
"_MCA_telvanni_breton_m"	"Telvanni Mage"
"_MCA_telvanni_breton_f"	"Telvanni Mage"
"_MCA_telvanni_dunmer_m"	"Telvanni Mage"
"_MCA_telvanni_dunmer_f"	"Telvanni Mage"
"_MCA_noble_breton_m"	"Nobleman"
"_MCA_noble_nord_m"	"Nobleman"
"_MCA_noble_redguard_m"	"Nobleman"
"_MCA_noble_altmer_m"	"Nobleman"
"_MCA_noble_bosmer_m"	"Nobleman"
"_MCA_noble_nord_f1"	"Noblewoman"
"_MCA_noble_nord_f3"	"Noblewoman"
"_MCA_noble_nord_f6"	"Noblewoman"
"_MCA_noble_nord_f5"	"Noblewoman"
"_MCA_noble_nord_f2"	"Noblewoman"
"_MCA_noble_nord_f4"	"Noblewoman"
"_MCA_noble_redguard_f2"	"Noblewoman"
"_MCA_noble_redguard_f5"	"Noblewoman"
"_MCA_noble_redguard_f4"	"Noblewoman"
"_MCA_noble_redguard_f3"	"Noblewoman"
"_MCA_noble_redguard_f6"	"Noblewoman"
"_MCA_noble_redguard_f1"	"Noblewoman"
"_MCA_noble_bosmer_f2"	"Noblewoman"
"_MCA_noble_bosmer_f4"	"Noblewoman"
"_MCA_noble_bosmer_f6"	"Noblewoman"
"_MCA_noble_bosmer_f5"	"Noblewoman"
"_MCA_noble_bosmer_f1"	"Noblewoman"
"_MCA_noble_bosmer_f3"	"Noblewoman"
"_MCA_noble_altmer_f2"	"Noblewoman"
"_MCA_noble_altmer_f4"	"Noblewoman"
"_MCA_noble_altmer_f5"	"Noblewoman"
"_MCA_noble_altmer_f3"	"Noblewoman"
"_MCA_noble_altmer_f6"	"Noblewoman"
"_MCA_noble_altmer_f1"	"Noblewoman"
"_MCA_noble_dunmer_f6"	"Nobleman"
"_MCA_imp_patrol_nord"	"Imperial Legionary"
"_MCA_BM_wraith_lord"	"Frost Wraith Lord"
"_MCA_BM_wraith_ambush"	
"_MCA_wild_f_altmer_m"	"Fledgling Vampire"
"_MCA_wild_f_altmer_f"	"Fledgling Vampire"
"_MCA_wild_f_bosmer_f"	"Fledgling Vampire"
"_MCA_wild_f_bosmer_m"	"Fledgling Vampire"
"_MCA_wild_f_breton_m"	"Fledgling Vampire"
"_MCA_wild_f_breton_f"	"Fledgling Vampire"
"_MCA_wild_f_dunmer_f"	"Fledgling Vampire"
"_MCA_wild_f_dunmer_m"	"Fledgling Vampire"
"_MCA_wild_f_imperial_m"	"Fledgling Vampire"
"_MCA_wild_f_imperial_f"	"Fledgling Vampire"
"_MCA_wild_f_nord_f"	"Fledgling Vampire"
"_MCA_wild_f_nord_m"	"Fledgling Vampire"
"_MCA_wild_f_orc_m"	"Fledgling Vampire"
"_MCA_wild_f_orc_f"	"Fledgling Vampire"
"_MCA_wild_f_redguard_f"	"Fledgling Vampire"
"_MCA_wild_f_redguard_m"	"Fledgling Vampire"
"_MCA_wild_f_khajiit_m"	"Fledgling Vampire"
"_MCA_wild_f_khajiit_f"	"Fledgling Vampire"
"_MCA_wild_f_argonian_f"	"Fledgling Vampire"
"_MCA_wild_f_argonian_m"	"Fledgling Vampire"
"_MCA_wild_v_altmer_f"	"Vampire"
"_MCA_wild_v_altmer_m"	"Vampire"
"_MCA_wild_v_bosmer_m"	"Vampire"
"_MCA_wild_v_bosmer_f"	"Vampire"
"_MCA_wild_v_breton_f"	"Vampire"
"_MCA_wild_v_breton_m"	"Vampire"
"_MCA_wild_v_dunmer_m"	"Vampire"
"_MCA_wild_v_dunmer_f"	"Vampire"
"_MCA_wild_v_imperial_f"	"Vampire"
"_MCA_wild_v_imperial_m"	"Vampire"
"_MCA_wild_v_nord_m"	"Vampire"
"_MCA_wild_v_nord_f"	"Vampire"
"_MCA_wild_v_redguard_f"	"Vampire"
"_MCA_wild_v_redguard_m"	"Vampire"
"_MCA_wild_v_khajiit_m"	"Vampire"
"_MCA_wild_v_khajiit_f"	"Vampire"
"_MCA_wild_v_argonian_f"	"Vampire"
"_MCA_wild_v_argonian_m"	"Vampire"
"_MCA_wild_v_orc_f"	"Vampire"
"_MCA_wild_v_orc_m"	"Vampire"
"_MCA_wild_a_altmer_f"	"Ancient Vampire"
"_MCA_wild_a_altmer_m"	"Ancient Vampire"
"_MCA_wild_a_bosmer_m"	"Ancient Vampire"
"_MCA_wild_a_bosmer_f"	"Ancient Vampire"
"_MCA_wild_a_dunmer_f"	"Ancient Vampire"
"_MCA_wild_a_dunmer_m"	"Ancient Vampire"
"_MCA_wild_a_breton_m"	"Ancient Vampire"
"_MCA_wild_a_breton_f"	"Ancient Vampire"
"_MCA_wild_a_imperial_f"	"Ancient Vampire"
"_MCA_wild_a_imperial_m"	"Ancient Vampire"
"_MCA_wild_a_nord_m"	"Ancient Vampire"
"_MCA_wild_a_nord_f"	"Ancient Vampire"
"_MCA_wild_a_redguard_f"	"Ancient Vampire"
"_MCA_wild_a_redguard_m"	"Ancient Vampire"
"_MCA_wild_e_bosmer_f"	"Elder Vampire"
"_MCA_wild_e_breton_f"	"Elder Vampire"
"_MCA_wild_e_imperial_f"	"Elder Vampire"
"_MCA_wild_e_dunmer_f"	"Elder Vampire"
"_MCA_wild_e_nord_f"	"Elder Vampire"
"_MCA_wild_e_redguard_f"	"Elder Vampire"
"_MCA_wild_e_redguard_m"	"Elder Vampire"
"_MCA_wild_e_nord_m"	"Elder Vampire"
"_MCA_wild_e_imperial_m"	"Elder Vampire"
"_MCA_wild_e_breton_m"	"Elder Vampire"
"_MCA_wild_e_dunmer_m"	"Elder Vampire"
"_MCA_wild_e_bosmer_m"	"Elder Vampire"
"_MCA_wild_e_altmer_m"	"Elder Vampire"
"_MCA_outlaw15_khajiit_m"	"Warrior"
"_MCA_outlaw15_khajiit_f"	"Warrior"
"_MCA_outlaw15_arg_m"	"Warrior"
"_MCA_outlaw15_arg_f"	"Warrior"
"_MCA_outlaw20_khajiit_f"	"Archer"
"_MCA_outlaw20_arg_f"	"Archer"
"_MCA_outlaw20_khajiit_m"	"Archer"
"_MCA_outlaw20_arg_m"	"Archer"
"_MCA_BM_corpse_m"	"Corpse"
"_MCA_BM_corpse_f"	"Corpse"
"_MCA_BM_corpse_skeleton"	"Corpse"
"_MCA_BM_corpse_zombie"	"Corpse"
"_MCA_corpse_zombie_f"	"Corpse"
"_MCA_outlaw40_khajiit_f"	"Outlaw"
"_MCA_outlaw40_khajiit_m"	"Outlaw"
"_MCA_outlaw40_arg_m"	"Outlaw"
"_MCA_outlaw40_arg_f"	"Outlaw"
"_MCA_outlaw35_altmer_m"	"Marksman"
"_MCA_outlaw35_bosmer_m"	"Marksman"
"_MCA_outlaw35_breton_m"	"Marksman"
"_MCA_outlaw35_dunmer_m"	"Marksman"
"_MCA_outlaw35_imp_m"	"Marksman"
"_MCA_outlaw35_nord_m"	"Marksman"
"_MCA_outlaw35_orc_m"	"Marksman"
"_MCA_outlaw35_redg_m"	"Marksman"
"_MCA_outlaw35_khajiit_m"	"Marksman"
"_MCA_outlaw35_arg_m"	"Marksman"
"_MCA_outlaw35_altmer_f"	"Markswoman"
"_MCA_outlaw35_bosmer_f"	"Markswoman"
"_MCA_outlaw35_dunmer_f"	"Markswoman"
"_MCA_outlaw35_orc_f"	"Markswoman"
"_MCA_outlaw35_breton_f"	"Markswoman"
"_MCA_outlaw35_imp_f"	"Markswoman"
"_MCA_outlaw35_nord_f"	"Markswoman"
"_MCA_outlaw35_redg_f"	"Markswoman"
"_MCA_outlaw35_khajiit_f"	"Markswoman"
"_MCA_outlaw35_arg_f"	"Markswoman"
"_MCA_witch_khajiit_f"	"Witch"
"_MCA_witch_khajiit_m"	"Warlock"
"_MCA_witch_argonian_m"	"Warlock"
"_MCA_witch_argonian_f"	"Witch"
"_MCA_seducer_01"	"Seducer"
"_MCA_seducer_02"	"Seducer"
"_MCA_seducer_03"	"Seducer"
"_MCA_seducer_04"	"Seducer"
"_MCA_seducer_05"	"Seducer Queen"
"_MCA_dremora_warrior"	"Dremora Warrior"
"_MCA_dremora_champion"	"Dremora Champion"
"_MCA_dremora_battlemage"	"Dremora Battlemage"
"_MCA_dremora_warmaster"	"Dremora Warmaster"
"_MCA_dremora_marksman"	"Dremora Marksman"
"_MCA_paladin_mara_bre_f"	"Paladin"
"_MCA_paladin_mara_imp_f"	"Paladin"
"_MCA_paladin_mara_nor_f"	"Paladin"
"_MCA_paladin_mara_nor_m"	"Paladin"
"_MCA_paladin_mara_imp_m"	"Paladin"
"_MCA_paladin_mara_bre_m"	"Paladin"
"_MCA_paladin_akat_bre_f"	"Paladin"
"_MCA_paladin_akat_imp_f"	"Paladin"
"_MCA_paladin_akat_nor_f"	"Paladin"
"_MCA_paladin_akat_nor_m"	"Paladin"
"_MCA_paladin_akat_imp_m"	"Paladin"
"_MCA_paladin_akat_bre_m"	"Paladin"
"_MCA_paladin_arka_bre_m"	"Paladin"
"_MCA_paladin_kyna_bre_m"	"Paladin"
"_MCA_paladin_dibe_bre_m"	"Paladin"
"_MCA_paladin_jet_bre_m"	"Paladin"
"_MCA_paladin_jet_bre_f"	"Paladin"
"_MCA_paladin_jet_imp_f"	"Paladin"
"_MCA_paladin_jet_imp_m"	"Paladin"
"_MCA_paladin_jet_nor_m"	"Paladin"
"_MCA_paladin_jet_nor_f"	"Paladin"
"_MCA_paladin_dibe_bre_f"	"Paladin"
"_MCA_paladin_dibe_imp_f"	"Paladin"
"_MCA_paladin_dibe_imp_m"	"Paladin"
"_MCA_paladin_dibe_nor_m"	"Paladin"
"_MCA_paladin_dibe_nor_f"	"Paladin"
"_MCA_paladin_arka_bre_f"	"Paladin"
"_MCA_paladin_arka_imp_f"	"Paladin"
"_MCA_paladin_arka_imp_m"	"Paladin"
"_MCA_paladin_arka_nor_m"	"Paladin"
"_MCA_paladin_arka_nor_f"	"Paladin"
"_MCA_paladin_kyna_bre_f"	"Paladin"
"_MCA_paladin_kyna_imp_f"	"Paladin"
"_MCA_paladin_kyna_imp_m"	"Paladin"
"_MCA_paladin_kyna_nor_m"	"Paladin"
"_MCA_paladin_kyna_nor_f"	"Paladin"
"_MCA_companion_arran"	"Arran"
"_MCA_companion_zarna"	"Zarna"
"_MCA_guard_hlaalu_f2"	"Hlaalu Archer"
"_MCA_guard_redoran_f2"	"Redoran Archer"
"_MCA_guard_telvanni_f2"	"Telvanni Archer"
"_MCA_guard_hlaalu_m2"	"Hlaalu Archer"
"_MCA_guard_redoran_m2"	"Redoran Archer"
"_MCA_guard_telvanni_m2"	"Telvanni Archer"
"_MCA_ordinator_elite_m"	"Elite Ordinator"
"_MCA_crusader_breton_m"	"Crusader"
"_MCA_crusader_breton_f"	"Crusader"
"_MCA_crusader_nord_f"	"Crusader"
"_MCA_crusader_imp_f"	"Crusader"
"_MCA_crusader_nord_m"	"Crusader"
"_MCA_crusader_imp_m"	"Crusader"
"_MCA_courtesan_bret_f8"	"Courtesan"
"_MCA_courtesan_dun_f6"	"Courtesan"
"_MCA_courtesan_imp_f5"	"Courtesan"
"_MCA_courtesan_nord_f5"	"Courtesan"
"_MCA_courtesan_nord_f6"	"Courtesan"
"_MCA_courtesan_nord_f7"	"Courtesan"
"_MCA_courtesan_bret_f9"	"Courtesan"
"_MCA_merchants_cart_01"	"Merchant's Cart"
"_MCA_merchants_cart_02"	"Merchant's Cart"
"_MCA_merchant_bosmer_m"	"Traveling Merchant"
"_MCA_merchant_breton_m"	"Traveling Merchant"
"_MCA_merchant_dunmer_m"	"Traveling Merchant"
"_MCA_merchant_altmer_m"	"Traveling Merchant"
"_MCA_merchant_imp_m"	"Traveling Merchant"
"_MCA_merchant_khajiit_m"	"Traveling Merchant"
"_MCA_merchant_khajiit_f"	"Traveling Merchant"
"_MCA_merchant_nord_m"	"Traveling Merchant"
"_MCA_merchant_redg_m"	"Traveling Merchant"
"_MCA_merchant_nord_f"	"Traveling Merchant"
"_MCA_merchant_breton_f"	"Traveling Merchant"
"_MCA_merchant_altmer_f"	"Traveling Merchant"
"_MCA_merchant_redg_f"	"Traveling Merchant"
"_MCA_merchant_imp_f"	"Traveling Merchant"
"_MCA_merchant_dunmer_f"	"Traveling Merchant"
"_MCA_merchant_bosmer_f"	"Traveling Merchant"
"_MCA_merchant_arg_f"	"Traveling Merchant"
"_MCA_merchant_arg_m"	"Traveling Merchant"
"_MCA_druid_breton_m"	"Druid"
"_MCA_druid_breton_f"	"Druid"
"_MCA_druid_imperial_f"	"Druid"
"_MCA_druid_imperial_m"	"Druid"
"_MCA_druid_nord_m"	"Druid"
"_MCA_druid_nord_f"	"Druid"
"_MCA_druid_bosmer_f"	"Druid"
"_MCA_druid_bosmer_m"	"Druid"
"_MCA_bard_altmer_m"	"Bard"
"_MCA_minstrel_altmer_m"	"Minstrel"
"_MCA_bard_altmer_f"	"Bard"
"_MCA_bard_bosmer_m"	"Bard"
"_MCA_bard_dunmer_m"	"Bard"
"_MCA_bard_imperial_m"	"Bard"
"_MCA_bard_nord_m"	"Bard"
"_MCA_bard_redguard_m"	"Bard"
"_MCA_bard_bosmer_f"	"Bard"
"_MCA_bard_dunmer_f"	"Bard"
"_MCA_bard_imperial_f"	"Bard"
"_MCA_bard_nord_f"	"Bard"
"_MCA_bard_redguard_f"	"Bard"
"_MCA_bard_breton_f"	"Bard"
"_MCA_bard_breton_m"	"Bard"
"_MCA_minstrel_bosmer_m"	"Minstrel"
"_MCA_minstrel_dunmer_m"	"Minstrel"
"_MCA_minstrel_imp_m"	"Minstrel"
"_MCA_minstrel_breton_m"	"Minstrel"
"_MCA_minstrel_nord_m"	"Minstrel"
"_MCA_minstrel_redg_m"	"Minstrel"
"_MCA_illusionist_alt_f"	"Illusionist"
"_MCA_illusionist_alt_m"	"Illusionist"
"_MCA_illusionist_bos_m"	"Illusionist"
"_MCA_illusionist_bos_f"	"Illusionist"
"_MCA_illusionist_dun_f"	"Illusionist"
"_MCA_illusionist_dun_m"	"Illusionist"
"_MCA_illusionist_bre_m"	"Illusionist"
"_MCA_illusionist_bre_f"	"Illusionist"
"_MCA_illusionist_nord_f"	"Illusionist"
"_MCA_illusionist_nord_m"	"Illusionist"
"_MCA_illusionist_imp_m"	"Illusionist"
"_MCA_illusionist_imp_f"	"Illusionist"
"_MCA_illusionist_redg_f"	"Illusionist"
"_MCA_illusionist_redg_m"	"Illusionist"
"_MCA_illusionist_arg_m"	"Illusionist"
"_MCA_illusionist_arg_f"	"Illusionist"
"_MCA_illusionist_khaj_f"	"Illusionist"
"_MCA_illusionist_khaj_m"	"Illusionist"
"_MCA_minstrel_altmer_f"	"Minstrel"
"_MCA_minstrel_bosmer_f"	"Minstrel"
"_MCA_minstrel_breton_f"	"Minstrel"
"_MCA_minstrel_dunmer_f"	"Minstrel"
"_MCA_minstrel_imp_f"	"Minstrel"
"_MCA_minstrel_nord_f"	"Minstrel"
"_MCA_minstrel_redg_f"	"Minstrel"
"_MCA_bountyhunter_bos_m"	"Bounty Hunter"
"_MCA_bountyhunter_bos_f"	"Bounty Hunter"
"_MCA_bountyhunter_bre_f"	"Bounty Hunter"
"_MCA_bountyhunter_bre_m"	"Bounty Hunter"
"_MCA_bountyhunter_dun_m"	"Bounty Hunter"
"_MCA_bountyhunter_dun_f"	"Bounty Hunter"
"_MCA_bountyhunter_imp_f"	"Bounty Hunter"
"_MCA_bountyhunter_imp_m"	"Bounty Hunter"
"_MCA_bountyhunter_nor_m"	"Bounty Hunter"
"_MCA_bountyhunter_nor_f"	"Bounty Hunter"
"_MCA_bountyhunter_orc_f"	"Bounty Hunter"
"_MCA_bountyhunter_orc_m"	"Bounty Hunter"
"_MCA_bountyhunter_red_m"	"Bounty Hunter"
"_MCA_bountyhunter_red_f"	"Bounty Hunter"
"_MCA_companion_neo"	"Neoptolemus"
"_MCA_BM_draugr_lord"	"Draugr Lord"
"_MCA_barrow_wight"	"Barrow Wight"
"_MCA_BM_frost_lich01"	"Frost Lich"
"_MCA_BM_frost_lich05"	"Greater Frost Lich"
"_MCA_pack_rat"	"Pack Rat"
"_MCA_pack_guar"	"Pack Guar"
"_MCA_pack_guar_dead"	"Dead Pack Guar"
"_MCA_goblin"	"Goblin"
"_MCA_goblin_champion"	"Goblin Champion"
"_MCA_goblin_berserker"	"Goblin Berserker"
"_MCA_BM_frost_lich02"	"Frost Lich"
"_MCA_BM_frost_lich03"	"Frost Lich"
"_MCA_BM_frost_lich04"	"Frost Lich"
"_MCA_ash_vampire"	"Ash Vampire"
"_MCA_tame_wolf_black"	"Wolf"
"_MCA_tame_wolf_red"	"Wolf"
"_MCA_tame_wolf_white"	"Snow Wolf"
